****************************************
*   1            *     *  * 2  *     *x*
* ****  *   ****    *       *  *  *  *4*
* *  * ** ***********2*******  *  *  * *
*    *    *        *   *       *  *    *
*1****2*****11****1*   *  *******3******
*    *  *  *  *    **  *  *     *      *
*       *     ******   *      *******  *
* *********** *  *   **********     *  *
*      2      *               *  *3**  *
*************1***************2*  *     *
*                *          * *  *******
*1******  *****  *****2*  * * *   * *  *
*      *  * 1    *  1  *  * *1***   *  *
******1****      ****  ******  *    **2*
*         **21****     *       ***  *  *
*e  *     *         *  *3              *
****************************************